

BoardType	LITERAL1
Micro	LITERAL1
Uno	LITERAL1
Mega2560	LITERAL1
MegaADK	LITERAL1
LilyPad328	LITERAL1
BoardError	LITERAL1

ERR_EEPROM_FORMAT	LITERAL1
ERR_FLASH	LITERAL1
ERR_INVALID_SWITCHSTATE	LITERAL1
ERR_USER_ERRORA	LITERAL1
ERR_USER_ERRORB	LITERAL1
ERR_USER_ERRORC	LITERAL1
ERR_USER_ERRORD	LITERAL1

STR_Micro	LITERAL1
STR_Uno	LITERAL1
STR_Mega2560	LITERAL1
STR_MegaADK	LITERAL1
STR_LilyPad328	LITERAL1
STR_Unknown	LITERAL1
STR_type	LITERAL1
STR_id	LITERAL1
STR_i2c	LITERAL1
STR_loop	LITERAL1
STR_dur	LITERAL1
STR_magic	LITERAL1
STR_formatting	LITERAL1
STR_ver	LITERAL1
STR_verified	LITERAL1
STR_failed	LITERAL1
STR_stop	LITERAL1
STR_error	LITERAL1

Board	KEYWORD1
setup	KEYWORD2
type	KEYWORD2
id	KEYWORD2
i2c	KEYWORD2
isLoopMod	KEYWORD2
isHeartbeatEnabled	KEYWORD2
beginLoop	KEYWORD2
endLoop	KEYWORD2
getLoopCount	KEYWORD2
getLoopStartMicros	KEYWORD2
getLoopEndMicros	KEYWORD2
getLoopElapsedMicros	KEYWORD2
getLoopZeroTime	KEYWORD2
loopMillis	KEYWORD2
printReport	KEYWORD2
printLoopTiming	KEYWORD2
nameOfType	KEYWORD2
beginSerial	KEYWORD2
endSerial	KEYWORD2
setSerialBusy	KEYWORD2
isSerialOpen	KEYWORD2
isSerialBusy	KEYWORD2
green	KEYWORD2
yellow	KEYWORD2
red	KEYWORD2
rgbLed	KEYWORD2
rgbRed	KEYWORD2
rgbGreen	KEYWORD2
rgbBlue	KEYWORD2
stop	KEYWORD2
stop	KEYWORD2
isStopped	KEYWORD2
errmsg	KEYWORD2
errmsg	KEYWORD2
stopIfNotFormatted	KEYWORD2
debug	KEYWORD2
debugln	KEYWORD2

EEPROM_MAGIC_LOW	LITERAL1
EEPROM_MAGIC_HIGH	LITERAL1
EEPROM_VERSION	LITERAL1
EEPROM_BOARDTYPE	LITERAL1
EEPROM_BOARDID	LITERAL1
EEPROM_DEBUG_MODE	LITERAL1
EEPROM_SYSTEM_MODE	LITERAL1
EEPROM_USERMODE	LITERAL1
EEPROM_USERAREA	LITERAL1
DEBUG_SERIAL	LITERAL1
DEBUG_VERBOSE	LITERAL1
DEBUG_BROADCAST	LITERAL1
DEBUG_TELEMETRY	LITERAL1
DEBUG_UNUSED4	LITERAL1
DEBUG_UNUSED5	LITERAL1
DEBUG_UNUSED6	LITERAL1
DEBUG_UNUSED7	LITERAL1

Flash	KEYWORD1
isFormatted	KEYWORD2
ifetch	KEYWORD2
istash	KEYWORD2
setVersion	KEYWORD2
getVersion	KEYWORD2
isVersion	KEYWORD2
setBoardType	KEYWORD2
getBoardType	KEYWORD2
setBoardId	KEYWORD2
getBoardId	KEYWORD2
setDebugMode	KEYWORD2
getDebugMode	KEYWORD2
setDebugModeBit	KEYWORD2
isDebugMode	KEYWORD2
toggleDebugModeBit	KEYWORD2
maybeSetDebugModeBit	KEYWORD2
